{
    "al": "ALL",
    "dz": "DZD",
    "af": "AFN",
    "ad": "EUR",
    "ao": "AOA",
    "ag": "XCD",
    "ar": "ARS",
    "am": "AMD",
    "au": "AUD",
    "at": "EUR",
    "az": "AZN",
    "bs": "BSD",
    "bh": "BHD",
    "bd": "BDT",
    "bb": "BBD",
    "be": "EUR",
    "bz": "BZD",
    "bj": "XOF",
    "bt": "BTN",
    "bo": "BOB",
    "ba": "BAM",
    "bw": "BWP",
    "br": "BRL",
    "bn": "BND",
    "bg": "BGN",
    "bf": "XOF",
    "bi": "BIF",
    "cv": "CVE",
    "kh": "KHR",
    "cm": "XAF",
    "ca": "CAD",
    "cf": "XAF",
    "td": "XAF",
    "cl": "CLP",
    "co": "COP",
    "km": "KMF",
    "cg": "XAF",
    "cd": "CDF",
    "cr": "CRC",
    "ci": "XOF",
    "hr": "EUR",
    "cy": "EUR",
    "cz": "CZK",
    "dk": "DKK",
    "dj": "DJF",
    "dm": "XCD",
    "do": "DOP",
    "ec": "USD",
    "eg": "EGP",
    "sv": "USD",
    "gq": "XAF",
    "er": "ERN",
    "ee": "EUR",
    "sz": "SZL",
    "et": "ETB",
    "fj": "FJD",
    "fi": "EUR",
    "fr": "EUR",
    "ga": "XAF",
    "gm": "GMD",
    "ge": "GEL",
    "de": "EUR",
    "gh": "GHS",
    "gr": "EUR",
    "gd": "XCD",
    "gt": "GTQ",
    "gn": "GNF",
    "gw": "XOF",
    "gy": "GYD",
    "ht": "HTG",
    "va": "EUR",
    "hn": "HNL",
    "hu": "HUF",
    "is": "ISK",
    "in": "INR",
    "id": "IDR",
    "iq": "IQD",
    "ie": "EUR",
    "il": "ILS",
    "it": "EUR",
    "jm": "JMD",
    "jp": "JPY",
    "jo": "JOD",
    "kz": "KZT",
    "ke": "KES",
    "ki": "AUD",
    "kw": "KWD",
    "kg": "KGS",
    "la": "LAK",
    "lv": "EUR",
    "lb": "LBP",
    "ls": "LSL",
    "lr": "LRD",
    "ly": "LYD",
    "li": "CHF",
    "lt": "EUR",
    "lu": "EUR",
    "mg": "MGA",
    "mw": "MWK",
    "my": "MYR",
    "mv": "MVR",
    "ml": "XOF",
    "mt": "EUR",
    "mh": "USD",
    "mr": "MRU",
    "mu": "MUR",
    "mx": "MXN",
    "fm": "USD",
    "md": "MDL",
    "mc": "EUR",
    "mn": "MNT",
    "me": "EUR",
    "ma": "MAD",
    "mz": "MZN",
    "mm": "MMK",
    "na": "NAD",
    "nr": "AUD",
    "np": "NPR",
    "nl": "EUR",
    "nz": "NZD",
    "ni": "NIO",
    "ne": "XOF",
    "ng": "NGN",
    "mk": "MKD",
    "no": "NOK",
    "om": "OMR",
    "pk": "PKR",
    "pw": "USD",
    "ps": "ILS",
    "pa": "PAB",
    "pg": "PGK",
    "py": "PYG",
    "pe": "PEN",
    "ph": "PHP",
    "pl": "PLN",
    "pt": "EUR",
    "qa": "QAR",
    "ro": "RON",
    "rw": "RWF",
    "kn": "XCD",
    "lc": "XCD",
    "vc": "XCD",
    "ws": "WST",
    "sm": "EUR",
    "st": "STN",
    "sa": "SAR",
    "sn": "XOF",
    "rs": "RSD",
    "sc": "SCR",
    "sl": "SLL",
    "sg": "SGD",
    "sk": "EUR",
    "si": "EUR",
    "sb": "SBD",
    "so": "SOS",
    "za": "ZAR",
    "kr": "KRW",
    "ss": "SSP",
    "es": "EUR",
    "lk": "LKR",
    "sr": "SRD",
    "se": "SEK",
    "ch": "CHF",
    "sd": "SDG",
    "tw": "TWD",
    "tj": "TJS",
    "tz": "TZS",
    "th": "THB",
    "tl": "USD",
    "tg": "XOF",
    "to": "TOP",
    "tt": "TTD",
    "tn": "TND",
    "tr": "TRY",
    "tm": "TMT",
    "tv": "AUD",
    "ug": "UGX",
    "ua": "UAH",
    "ae": "AED",
    "gb": "GBP",
    "us": "USD",
    "uy": "UYU",
    "uz": "UZS",
    "vu": "VUV",
    "vn": "VND",
    "ye": "YER",
    "zm": "ZMW",
    "zw": "ZWL"
}
