{
    "us": "USD",
    "ca": "CAD",
    "gb": "GBP",
    "de": "EUR",
    "fr": "EUR",
    "it": "EUR",
    "es": "EUR",
    "nl": "EUR",
    "pt": "EUR",
    "fi": "EUR",
    "no": "NOK",
    "se": "SEK",
    "ch": "CHF",
    "jp": "JPY",
    "kr": "KRW",
    "cn": "CNY",
    "hk": "HKD",
    "tw": "TWD",
    "sg": "SGD",
    "au": "AUD",
    "nz": "NZD",
    "in": "INR",
    "id": "IDR",
    "my": "MYR",
    "ph": "PHP",
    "th": "THB",
    "vn": "VND",
    "ae": "AED",
    "sa": "SAR",
    "qa": "QAR",
    "kw": "KWD",
    "eg": "EGP",
    "za": "ZAR",
    "br": "BRL",
    "mx": "MXN",
    "ru": "RUB",
    "tr": "TRY"
}
